0 0 0 0 0 0 0 0 0 0 0 0 0 0 0 0 0 0 0 0 0 0 0 0 0 0 0 0 0 0 0 0 0 0 0 0 0 0 0 0 0 1 2 0 0 0 3 4 0 1 2 0 0 0 0 0 0 0 0 0 0 0 0 0 0 0 0 0 0 0 0 0 0 0 0 0 0 0 0 0 0 0 0 0 0 0 0 0 0 0 0 0 0 0 0 0 0 0 0 0 0 0 0 0 0 0 0 0 0 0 0 0 0 0 0 0 0 0 0 5 6 1 2 0 0 0 0 0 0 0 0 0 0 0 0 0 0 0 0 0 0 0 0 0 0 0 0 7 8 9 10 7 8 11 12 13 14 14 14 14 14 14 14 14 14 14 14 14 14 14 14 14 14 14 14 15 
0 0 0 0 0 0 3 4 0 0 0 0 0 0 0 5 6 0 0 0 3 4 0 0 0 0 0 0 0 0 0 0 0 0 0 0 0 0 0 0 16 17 18 19 0 7 20 21 22 17 18 23 6 0 0 0 0 0 0 0 0 0 0 0 0 0 0 0 0 0 0 0 0 0 0 0 0 0 0 0 0 0 0 0 3 4 0 0 0 0 0 0 0 0 0 0 0 0 0 0 3 4 0 0 0 0 0 0 0 0 0 0 0 0 0 0 0 0 24 25 26 27 18 19 0 0 0 0 0 0 0 0 0 0 0 0 0 0 0 0 0 0 0 0 0 0 0 0 28 29 0 0 28 30 31 13 14 14 14 14 14 14 14 14 14 14 14 14 14 14 14 14 14 14 14 15 
0 0 0 0 0 7 20 21 10 0 0 0 0 0 24 25 32 33 0 7 20 21 10 0 0 0 0 0 0 0 0 0 0 0 0 0 34 35 36 0 0 37 38 0 0 0 39 40 0 37 41 25 32 33 0 0 0 0 0 0 0 0 0 0 0 0 0 0 0 0 0 0 0 0 0 0 0 0 3 4 0 0 0 7 20 21 10 0 0 0 0 0 0 0 0 0 0 0 0 7 20 21 10 0 0 0 0 0 0 0 0 0 0 0 0 0 0 0 0 42 43 37 38 0 0 0 0 0 0 0 0 0 0 0 0 0 0 0 0 0 0 0 0 0 0 0 0 0 0 0 0 0 0 44 31 13 14 14 14 14 14 14 14 14 14 14 14 14 14 14 14 14 14 14 14 15 
0 0 0 0 0 0 28 29 0 0 0 0 0 1 2 45 46 0 0 0 28 29 3 4 0 0 0 0 0 0 0 0 0 0 0 7 47 48 49 19 0 0 0 0 0 7 20 21 10 0 0 42 50 0 0 0 0 0 0 5 6 0 0 0 0 0 0 0 0 0 0 0 0 0 0 0 0 7 20 21 10 0 0 0 28 29 0 0 0 0 0 0 0 1 2 0 0 0 0 0 28 29 0 0 3 4 0 5 6 0 0 0 0 0 0 0 0 0 0 0 0 0 0 0 0 0 0 0 0 0 0 0 0 0 0 0 0 0 0 0 0 0 0 0 0 0 0 0 0 0 0 0 0 44 31 13 14 14 14 14 14 14 14 14 14 14 14 14 14 14 14 14 14 14 14 15 
0 0 0 0 0 0 0 0 0 0 0 0 16 17 51 52 32 53 54 4 0 7 20 21 10 0 0 0 0 0 0 0 0 0 0 0 55 56 57 0 0 0 0 0 0 0 28 29 0 0 0 0 0 0 0 0 0 0 24 25 32 33 0 0 0 0 0 0 0 0 0 0 0 0 0 0 0 0 28 29 0 0 0 0 0 0 0 0 0 0 0 0 58 59 18 19 0 0 0 0 0 0 0 7 20 21 60 25 32 33 0 0 0 0 0 5 6 0 0 0 0 0 0 0 0 0 0 0 0 0 0 0 0 0 0 0 0 0 3 4 0 0 0 0 0 0 0 0 0 0 0 0 0 44 31 13 14 14 14 14 14 14 14 14 14 14 14 14 14 14 14 14 14 14 14 15 
0 0 0 0 0 0 0 0 0 0 0 0 0 37 38 42 61 62 63 64 10 0 28 29 0 0 0 0 0 0 0 0 0 0 0 0 0 0 0 0 0 0 0 0 0 0 0 0 0 0 0 0 0 0 0 0 0 0 0 42 50 0 0 0 0 0 0 0 0 0 0 0 0 0 0 0 0 0 0 0 0 0 0 0 0 0 0 0 0 0 3 65 66 67 68 0 0 0 0 0 0 0 0 0 28 29 0 42 50 0 0 0 0 0 24 25 32 33 0 0 0 0 0 0 0 0 0 0 0 0 0 0 0 0 0 0 0 7 20 21 10 0 0 0 0 0 0 0 0 0 0 0 0 44 31 13 14 14 14 14 14 14 14 14 14 14 14 14 14 14 14 14 14 14 14 15 
0 0 0 0 0 0 0 0 0 0 0 0 0 0 0 0 0 37 69 29 0 0 0 0 0 0 0 0 0 0 0 0 0 0 0 0 0 0 0 0 0 0 0 0 0 0 0 0 0 0 0 0 0 0 0 0 0 0 0 0 0 0 0 0 0 0 0 0 3 4 0 0 0 0 0 0 0 0 0 0 0 0 0 0 0 0 0 0 0 7 20 70 71 72 18 19 0 0 0 0 0 0 0 0 0 0 0 0 0 0 0 0 0 0 0 42 50 0 0 0 0 0 0 0 0 0 0 0 0 0 0 5 6 0 0 0 0 0 28 29 73 74 75 0 0 0 0 0 0 0 0 0 0 44 31 13 14 14 14 14 14 14 14 14 14 14 14 14 14 14 14 14 14 14 14 15 
0 0 0 0 0 0 0 0 0 0 0 0 0 0 0 0 0 0 0 0 0 0 0 0 0 0 0 0 0 0 0 0 0 0 0 0 0 0 0 0 0 0 0 0 0 0 0 0 0 0 0 0 0 0 0 0 0 0 0 0 0 0 0 0 0 0 0 7 20 21 10 0 0 1 2 5 6 0 0 0 0 0 0 0 0 0 0 0 0 76 77 29 0 37 38 0 0 0 0 0 0 0 0 0 0 0 0 0 0 0 0 0 0 0 0 0 0 0 0 0 0 0 0 0 0 0 0 0 0 0 24 25 32 33 0 0 0 0 0 78 79 80 81 82 0 0 0 0 0 0 0 0 0 44 31 13 14 14 14 14 14 14 14 14 14 14 14 14 14 14 14 14 14 14 14 15 
0 0 0 0 0 0 0 0 0 0 0 0 0 0 0 0 0 0 0 0 0 0 0 0 0 0 0 0 0 0 0 0 0 0 0 0 0 0 0 0 0 0 0 0 0 0 0 0 0 0 0 0 0 0 0 0 0 0 0 0 0 0 0 0 0 0 0 0 28 29 0 0 16 17 51 52 32 33 0 0 83 84 85 85 86 87 3 4 88 89 90 91 0 0 0 0 0 0 0 0 0 0 0 0 0 0 0 0 0 0 0 0 0 0 0 0 0 0 0 5 6 0 0 0 0 0 0 0 0 0 0 42 50 0 0 0 0 0 0 92 93 94 95 0 0 0 0 0 0 0 3 4 0 44 31 13 14 14 14 14 14 14 14 14 14 14 14 14 14 14 14 14 14 14 14 15 
0 0 0 0 0 0 0 0 0 0 0 0 0 0 0 0 0 0 0 0 0 0 0 0 0 0 0 0 0 0 0 0 0 0 0 0 0 0 0 0 0 0 0 0 0 0 0 0 0 0 0 0 0 0 0 0 0 0 0 0 0 0 0 0 0 0 0 0 0 0 0 0 0 37 38 42 50 0 0 0 96 97 98 99 100 101 102 21 10 103 104 0 0 0 0 0 0 0 0 0 0 0 0 0 0 0 0 0 0 0 0 0 0 0 0 0 0 0 24 25 32 33 0 0 0 0 0 0 0 0 0 0 0 0 0 0 0 0 0 92 105 106 107 0 0 0 0 0 0 7 20 21 10 44 31 13 14 14 14 14 14 14 14 14 14 14 14 14 14 14 14 14 14 14 14 15 
0 0 0 0 0 0 0 0 0 0 0 0 0 0 0 0 0 0 0 0 0 0 0 0 0 0 0 0 0 0 0 0 0 0 0 0 0 0 0 0 0 0 0 0 0 0 0 0 0 0 0 0 0 0 0 0 0 0 0 0 0 0 0 0 0 0 0 0 0 0 0 0 0 0 0 0 0 0 0 0 108 109 110 111 112 113 114 29 0 0 0 0 115 116 116 116 116 116 116 116 116 116 116 116 116 117 0 0 0 0 0 0 0 0 0 0 0 0 0 42 50 0 0 0 0 0 0 0 0 0 0 0 0 0 0 0 0 0 0 92 105 106 107 0 0 0 0 0 0 0 28 29 0 44 31 13 14 14 14 14 14 14 14 14 14 14 14 14 14 14 14 14 14 14 14 15 
0 0 0 0 0 0 0 0 0 0 0 0 0 0 0 0 0 0 0 0 0 0 0 0 0 0 0 0 0 0 0 0 0 0 0 0 0 0 0 0 0 0 0 0 0 0 0 0 0 0 0 0 0 0 0 0 0 0 0 0 0 0 0 0 0 0 0 0 0 0 0 0 0 0 0 0 0 0 0 0 118 119 120 121 122 123 124 115 116 116 116 125 126 127 128 128 128 128 128 128 128 128 128 128 129 130 0 0 0 0 0 0 0 0 0 0 0 0 0 0 0 0 0 0 0 0 0 0 0 0 0 0 0 0 0 0 0 0 0 92 105 106 107 0 0 0 0 0 0 0 0 0 0 44 31 13 14 14 14 14 14 14 14 14 14 14 14 14 14 14 14 14 14 14 14 15 
0 0 0 0 0 0 0 0 0 0 0 0 0 0 0 0 0 0 0 0 0 0 0 0 0 0 0 0 0 0 0 0 0 0 0 0 0 0 0 0 0 0 0 0 0 0 0 0 0 0 0 0 0 0 0 0 0 0 0 0 0 0 0 0 0 0 0 0 0 0 0 0 0 0 0 0 0 0 0 0 0 131 0 0 0 132 133 126 127 128 129 130 134 135 135 135 135 135 135 135 135 135 135 135 135 136 0 0 0 0 0 0 0 0 0 0 0 0 0 0 0 0 0 0 0 0 0 0 0 0 0 0 0 0 0 0 0 0 0 92 105 106 107 0 0 0 0 0 0 0 0 0 0 44 31 13 14 14 14 14 14 14 14 14 14 14 14 14 14 14 14 14 14 14 14 15 
0 0 0 0 0 0 0 0 0 0 0 0 0 0 0 0 0 0 0 0 0 0 0 0 0 0 0 0 0 0 0 0 0 0 0 0 0 0 0 0 0 0 0 0 0 0 0 0 0 0 0 0 0 0 0 0 0 0 0 0 0 0 0 0 0 0 0 0 0 0 0 0 0 0 0 0 0 0 0 0 0 0 0 0 0 0 0 134 135 135 135 136 0 0 0 0 0 0 0 0 0 0 0 0 0 0 0 0 0 0 0 0 0 0 0 0 0 0 0 0 0 0 0 0 0 0 0 0 0 0 0 0 0 0 0 0 0 0 0 92 105 106 107 0 0 0 0 0 0 0 0 0 0 44 31 13 14 14 14 14 14 14 14 14 14 14 14 14 14 14 14 14 14 14 14 15 
0 0 0 0 0 0 0 0 0 0 0 0 0 0 0 0 0 0 0 0 0 0 0 0 0 0 0 0 0 0 0 0 0 0 0 0 0 0 0 0 0 0 0 0 0 0 0 0 0 0 0 0 0 0 0 0 0 0 0 0 0 0 0 0 0 0 0 0 0 0 0 0 0 0 0 0 0 0 0 0 0 0 0 0 0 0 0 0 0 0 0 0 0 0 0 0 0 0 0 0 0 0 0 0 0 0 0 0 0 0 0 0 0 0 0 0 0 0 0 0 0 0 0 0 0 0 0 0 0 0 0 0 0 0 0 0 0 0 0 92 105 106 107 0 0 0 0 0 0 0 0 0 0 44 31 13 14 14 14 14 14 14 14 14 14 14 14 14 14 14 14 14 14 14 14 15 
0 0 0 0 0 0 0 0 0 0 0 0 0 0 0 0 0 0 0 137 138 139 0 0 0 0 0 0 0 0 0 0 0 0 0 0 0 0 0 0 0 0 0 0 0 0 0 0 0 0 0 0 0 0 0 0 0 0 0 0 0 0 0 0 0 0 0 0 0 0 0 0 0 0 0 0 0 0 0 0 0 0 0 0 0 0 0 0 0 0 0 0 0 0 0 0 0 0 0 0 0 0 0 0 0 0 0 0 0 0 0 0 0 0 0 0 0 0 0 0 0 0 0 0 0 0 0 0 0 0 0 0 0 0 0 0 0 0 0 92 105 106 107 0 0 0 0 0 0 0 0 0 0 44 31 13 14 14 14 14 14 14 14 14 14 14 14 14 14 14 14 14 14 14 14 15 
0 0 0 0 0 0 137 140 141 142 0 0 0 0 0 0 0 0 0 143 144 145 146 0 0 0 0 0 0 0 0 0 0 0 0 0 0 0 0 137 138 139 0 0 0 0 0 0 0 0 0 0 0 0 0 0 0 0 0 0 0 0 0 0 0 0 0 0 0 0 0 0 137 138 139 0 0 0 0 0 0 0 0 0 0 0 0 0 0 0 0 0 0 0 0 0 0 0 0 0 0 0 137 140 147 148 142 0 0 0 0 0 0 0 0 0 0 0 0 0 0 0 0 0 0 0 0 0 0 0 0 0 0 0 0 149 150 151 152 92 105 106 107 0 0 0 0 0 0 0 0 0 0 44 31 13 14 14 14 14 14 14 14 14 14 14 14 14 14 14 14 14 14 14 14 15 
0 0 0 0 0 0 143 153 154 155 146 0 0 0 0 0 0 0 0 156 157 158 159 0 0 0 0 0 0 0 0 0 0 0 0 0 0 0 0 143 144 145 146 0 0 0 0 0 0 0 0 0 0 0 0 0 0 0 0 0 0 0 0 0 0 0 0 0 0 0 0 0 143 144 145 146 0 0 0 0 0 0 0 0 0 0 0 0 0 0 0 0 0 0 0 0 0 0 0 0 0 0 143 153 160 161 155 146 0 0 0 0 0 0 0 0 0 0 0 0 0 0 0 0 0 0 0 0 0 0 0 0 0 0 162 163 164 165 166 167 105 106 107 0 137 138 139 0 0 168 169 170 0 44 31 13 14 14 14 14 14 14 14 14 14 14 14 14 14 14 14 14 14 14 14 15 
0 0 0 0 0 0 156 171 172 173 159 0 174 175 176 177 0 0 0 0 178 179 0 0 0 0 0 0 0 0 0 180 181 181 182 183 0 0 0 156 157 158 159 0 137 140 147 148 142 0 0 0 0 0 0 0 0 0 0 0 0 0 0 0 0 0 0 0 0 0 0 0 156 157 158 159 0 0 0 0 0 0 0 0 0 0 0 0 0 0 0 0 0 0 0 0 0 0 0 0 0 0 156 171 184 185 173 159 0 0 0 0 0 0 0 0 0 0 0 0 0 0 0 0 0 0 0 0 0 0 0 0 0 0 0 186 187 188 189 190 191 192 193 0 143 144 145 146 194 195 196 197 198 44 31 13 14 14 14 14 14 14 14 14 14 14 14 14 14 14 14 14 14 14 14 15 
0 0 0 0 0 0 0 199 200 201 0 0 202 203 204 205 206 0 0 0 0 0 0 0 174 175 207 0 0 0 208 209 210 211 212 213 214 0 0 0 178 179 0 0 143 153 160 161 155 146 0 0 0 0 0 0 0 0 0 0 0 0 0 0 0 0 0 0 0 0 0 0 0 178 179 0 0 0 0 0 0 0 215 216 216 216 216 217 218 219 0 0 0 0 0 0 0 0 0 0 0 0 0 199 220 221 201 0 0 0 0 0 0 0 0 0 0 0 0 0 0 0 0 0 0 0 0 0 0 0 0 0 0 0 0 222 187 187 223 224 225 226 227 228 156 157 158 159 229 230 231 232 233 234 31 13 14 14 14 14 14 14 14 14 14 14 14 14 14 14 14 14 14 14 14 15 
0 0 0 0 0 0 0 0 0 0 0 0 0 235 236 237 215 217 218 219 0 0 0 0 202 238 239 240 84 85 85 241 242 243 243 244 245 0 0 0 0 0 0 0 156 171 184 185 173 159 0 0 0 0 168 169 170 0 0 0 0 0 0 0 0 0 0 0 0 0 0 0 0 0 0 0 0 0 0 0 0 246 247 248 249 249 249 250 251 252 253 0 0 254 255 256 0 0 0 0 0 0 0 0 0 0 0 0 0 0 0 0 0 0 0 0 0 0 0 0 0 0 0 0 0 0 0 0 0 0 0 0 0 0 0 222 187 187 223 257 258 259 260 0 0 178 179 0 261 262 263 264 265 266 31 13 14 14 14 14 14 267 268 269 14 14 14 270 271 14 14 14 14 14 14 15 
0 168 169 170 0 0 0 0 0 174 175 176 177 0 0 246 247 272 251 252 253 0 0 0 0 273 237 96 274 275 276 277 278 279 243 280 245 0 0 0 0 0 174 175 207 199 220 221 201 0 0 168 169 281 282 283 284 285 170 168 169 170 0 0 0 0 0 0 0 0 0 0 0 0 0 0 0 0 0 83 84 85 286 287 287 287 288 289 290 291 245 0 292 293 294 295 228 0 0 0 0 0 0 0 0 0 0 0 0 0 0 0 0 0 0 0 0 0 0 0 0 0 0 0 0 0 0 0 0 0 0 0 0 0 0 222 187 187 223 245 0 0 0 0 0 0 0 296 297 298 299 300 301 302 31 13 14 14 14 14 14 303 14 304 14 14 14 305 306 14 14 14 14 14 14 15 
296 282 283 284 285 307 169 170 0 202 203 204 205 240 84 85 308 309 290 291 245 73 74 75 149 150 150 310 311 312 313 314 315 243 243 280 245 0 0 0 0 0 202 238 239 206 0 0 0 0 194 195 316 317 318 319 320 321 322 323 196 197 198 0 0 0 0 0 0 0 0 0 0 0 0 0 0 0 0 96 274 275 324 325 325 326 327 328 329 330 331 175 332 258 259 260 0 0 0 254 333 0 0 254 333 0 0 0 0 0 0 0 0 0 0 73 74 334 335 169 170 0 0 336 337 338 338 339 0 0 0 0 83 84 85 340 341 187 223 245 254 255 256 0 0 0 194 342 343 344 345 346 301 302 31 13 14 14 14 14 14 303 267 268 269 14 14 347 348 14 14 14 14 14 14 15 
349 350 319 320 351 352 353 197 198 0 235 236 237 96 274 354 355 356 329 330 357 79 80 358 359 360 361 362 363 364 365 366 367 368 368 369 370 152 0 174 371 372 373 374 375 376 377 378 0 0 379 380 381 382 383 384 385 386 387 388 389 390 233 391 392 393 378 0 0 0 0 0 0 0 0 0 0 0 149 150 394 395 395 395 396 312 397 398 399 330 400 238 239 206 0 0 0 0 401 402 403 404 405 406 407 408 0 0 0 0 0 73 74 75 78 79 80 409 410 196 197 198 411 412 413 414 415 416 91 0 76 339 96 274 354 417 418 419 223 224 420 421 422 423 73 74 424 425 426 427 428 429 430 431 31 13 14 14 14 14 14 303 14 14 304 14 14 14 14 14 14 14 267 268 269 15 
432 433 434 385 435 436 437 390 233 438 439 377 378 0 440 441 442 443 444 445 446 93 94 447 448 187 187 187 449 450 451 452 453 454 454 455 456 457 458 459 460 461 462 463 463 463 464 465 466 467 468 469 470 471 472 473 474 475 476 477 470 478 479 480 481 482 465 483 0 0 0 0 0 392 439 377 378 484 485 486 487 488 488 489 490 491 492 493 444 445 245 273 237 0 0 0 0 401 494 495 496 404 405 497 498 499 408 392 439 377 500 501 80 81 502 93 94 503 504 389 390 505 506 507 508 508 509 510 511 88 512 513 511 514 441 515 516 517 518 519 520 521 522 78 79 80 523 524 525 526 527 528 529 530 531 13 14 14 14 14 14 303 14 267 268 269 14 14 14 14 14 14 303 14 304 15 
532 533 473 534 535 536 537 478 538 539 540 464 465 541 542 543 544 545 546 547 548 549 550 551 552 553 554 555 556 557 558 559 560 554 554 555 561 562 563 564 565 566 567 567 567 567 567 568 569 569 570 571 572 573 573 573 573 573 574 571 572 573 575 569 576 567 577 578 579 0 0 580 581 481 540 464 465 582 583 584 554 554 554 555 585 586 587 545 546 547 588 589 589 590 0 580 591 592 593 594 595 596 597 598 599 600 601 602 540 464 603 604 605 606 607 549 608 609 610 470 611 612 613 614 614 614 615 616 617 618 619 620 621 622 543 623 624 625 626 627 628 629 630 607 631 605 632 633 634 635 635 636 637 638 639 640 641 641 641 641 642 643 644 641 641 645 641 641 641 641 641 642 643 644 645 646 
647 648 648 648 649 650 651 648 652 653 654 654 655 656 657 658 659 660 661 662 663 664 665 666 667 668 668 668 669 670 671 672 668 668 668 668 669 673 674 675 676 676 676 676 676 676 676 676 676 676 676 676 676 676 676 676 676 676 676 676 676 676 676 676 676 676 677 678 679 181 680 681 682 683 684 684 685 686 667 668 668 668 668 668 669 670 687 660 661 662 663 686 688 689 690 681 682 691 692 693 694 695 696 697 698 692 699 683 684 684 685 664 665 666 686 664 665 700 701 702 703 704 705 705 705 705 705 705 706 686 707 705 706 708 709 659 710 711 712 713 714 715 666 686 664 665 666 716 703 703 703 703 703 717 718 719 719 719 719 719 719 719 719 719 719 719 719 719 719 719 719 719 719 719 720 721 
722 723 723 723 723 723 723 723 723 723 723 723 723 723 724 725 726 727 727 727 727 727 727 727 727 727 727 727 727 727 727 727 727 727 727 727 727 728 729 730 730 730 730 730 730 730 730 730 730 730 730 730 730 730 730 730 730 730 730 730 730 730 730 730 730 730 730 731 732 732 732 733 727 727 727 727 727 727 727 727 727 727 727 727 727 727 727 727 727 727 727 727 727 734 735 733 727 727 727 727 734 735 732 733 727 727 727 727 727 727 727 727 727 727 727 727 727 727 727 727 727 727 727 727 727 727 727 727 727 727 727 727 727 727 727 727 727 727 727 736 737 727 727 727 727 727 727 727 727 727 727 727 727 727 727 727 727 727 727 727 727 727 727 727 727 727 727 727 727 727 727 727 727 727 727 738 