0 1 1 1 1 1 1 1 1 1 1 1 2 3 3 3 3 3 3 3 3 3 3 3 3 3 3 3 3 3 3 3 0 
0 1 1 1 1 1 1 1 1 1 1 1 2 3 3 3 3 3 3 3 3 3 3 3 3 3 3 3 3 3 3 3 0 
0 1 1 1 1 1 1 1 1 1 1 1 2 3 3 3 3 3 3 3 3 3 3 3 3 3 3 3 3 3 3 3 0 
0 1 1 5 6 7 1 1 1 1 1 1 2 3 3 3 3 3 3 3 3 3 3 3 3 3 3 3 3 3 3 3 0 
0 1 1 8 9 10 1 1 1 1 1 1 2 3 3 3 3 3 3 3 3 3 3 3 3 3 3 3 3 3 3 3 0 
0 1 1 1 1 1 1 1 1 1 1 1 2 3 3 3 3 3 11 12 3 3 3 13 14 15 3 3 3 3 3 3 0 
0 1 1 1 1 1 1 1 1 1 1 1 2 3 3 3 3 3 16 3 17 3 3 18 3 19 3 3 3 3 3 3 0 
0 1 1 1 1 1 1 1 1 1 1 1 2 3 3 3 3 3 16 11 12 3 3 20 21 22 3 3 3 3 3 3 0 
0 1 1 1 23 24 1 1 1 1 1 1 2 3 3 3 3 3 16 3 3 17 3 3 3 3 3 3 3 11 12 3 0 
0 1 1 1 25 26 24 1 27 28 0 1 2 3 3 3 3 3 16 3 11 12 3 3 3 3 3 3 3 16 3 17 0 
0 29 30 31 32 33 33 0 34 35 1 1 2 3 3 3 3 11 12 3 3 3 17 3 3 3 3 3 11 12 3 17 0 
36 37 37 37 37 37 37 37 37 37 37 37 37 37 37 37 37 37 37 37 37 37 37 37 37 37 37 37 37 37 37 37 0 
0 0 0 0 0 0 0 0 0 0 0 0 0 0 0 0 0 0 0 0 0 0 0 0 0 0 0 0 0 0 0 0 0 