0 1 2 2 2 2 2 2 2 2 2 2 2 2 2 2 2 2 2 2 2 2 2 2 2 2 2 3 4 5 2 2 2 2 2 2 2 2 2 2 2 2 2 2 3 6 5 2 2 2 2 2 2 2 2 2 2 2 2 2 2 2 2 2 2 2 2 2 3 6 5 2 2 2 2 2 2 2 2 2 2 2 2 3 4 5 2 2 2 2 2 2 2 2 2 2 2 2 2 7 2 2 2 2 2 2 2 2 2 2 2 2 2 2 2 2 2 2 2 2 2 2 2 2 2 3 4 5 2 2 2 2 2 2 2 2 2 2 2 2 2 2 2 2 2 2 2 2 2 2 2 2 3 6 5 8 9 10 11 11 11 11 11 11 11 11 11 11 11 11 11 11 11 11 11 11 12 13 
14 15 16 16 16 16 16 16 16 16 16 16 16 16 16 16 16 16 16 16 16 16 17 16 16 16 16 18 19 20 16 16 16 16 16 16 16 16 17 16 16 16 16 16 21 22 23 16 16 16 16 16 16 16 16 24 16 16 16 16 16 16 16 16 16 16 16 24 21 22 23 16 16 16 16 16 16 16 16 16 16 16 16 18 19 20 16 16 16 25 16 16 16 16 16 16 16 16 26 27 28 16 16 16 16 16 16 16 16 16 16 16 16 16 16 16 16 16 16 16 16 16 17 16 16 18 19 20 16 16 16 16 16 16 16 16 16 16 16 16 16 16 16 16 16 16 16 16 16 16 16 16 21 22 23 29 30 31 32 32 32 32 32 32 32 32 32 32 32 32 32 32 32 32 32 32 33 34 
35 15 16 16 16 16 16 16 16 16 16 16 16 16 16 16 16 16 17 16 16 18 36 20 16 16 16 37 38 39 16 16 16 16 16 16 16 18 36 20 16 16 16 16 40 41 42 16 16 16 16 16 16 16 26 43 28 16 16 16 16 16 16 16 16 16 26 43 44 41 42 24 16 16 16 16 16 16 16 16 16 16 16 37 38 39 16 16 21 45 23 16 16 16 16 16 16 16 46 47 48 16 16 16 16 16 16 16 16 16 16 16 17 16 16 16 16 16 16 16 16 18 36 20 16 37 38 39 16 16 16 16 16 16 16 16 16 16 16 16 16 16 16 16 16 16 16 16 16 16 16 16 40 41 42 49 50 31 32 32 32 32 32 32 32 32 32 32 32 32 32 32 32 32 32 32 33 51 
35 15 16 16 16 16 16 16 16 16 16 16 16 16 16 16 16 18 36 20 16 37 38 39 16 16 16 16 52 16 16 16 16 16 16 24 16 37 38 39 16 16 16 24 16 53 16 16 16 16 16 16 16 16 46 47 48 16 16 16 16 16 16 16 16 16 46 47 48 53 26 43 28 16 16 16 17 16 16 16 16 16 16 16 54 16 16 16 40 41 42 16 16 16 16 16 16 16 16 16 16 16 16 16 16 16 16 16 16 16 17 18 36 20 16 16 16 16 16 16 16 37 38 39 16 16 54 16 16 16 16 16 16 16 17 16 16 16 17 16 16 16 16 16 16 16 16 16 16 16 16 16 16 53 16 49 50 31 32 32 32 32 32 32 32 32 32 32 32 32 32 32 32 32 32 32 33 51 
35 15 16 16 16 16 16 16 16 16 16 16 16 16 16 16 16 37 38 39 16 25 54 16 16 16 16 18 36 20 16 16 16 16 26 43 28 16 54 16 16 16 26 43 28 16 16 16 16 16 17 16 16 16 16 16 16 16 16 16 16 16 16 24 16 16 16 16 16 16 46 47 48 16 16 18 36 55 16 16 16 16 16 16 56 56 56 16 16 53 16 16 16 16 16 16 16 16 16 16 16 16 16 16 16 16 16 16 16 18 36 57 38 39 16 16 16 16 16 16 16 16 54 16 16 16 16 16 16 16 16 16 16 18 36 20 16 18 36 20 16 16 16 16 16 16 17 16 16 16 16 16 16 16 16 49 50 31 32 32 32 32 32 32 32 32 32 32 32 32 32 32 32 32 32 32 33 51 
35 15 16 16 16 16 16 16 16 16 16 16 16 16 16 16 16 16 54 24 21 45 23 16 16 16 16 37 38 39 16 16 16 16 46 47 58 16 16 16 16 16 59 47 48 16 16 16 16 18 36 20 16 16 16 16 16 16 16 16 16 16 26 43 28 16 16 16 16 16 16 16 16 25 16 37 60 61 23 16 16 16 16 62 63 64 65 66 16 16 16 16 16 16 16 16 16 16 16 16 16 16 16 16 16 16 16 16 16 37 38 39 54 16 56 16 16 16 16 16 16 16 16 24 16 16 16 16 16 16 16 16 16 37 38 39 16 37 38 39 16 16 67 68 16 18 36 20 16 16 16 16 16 16 16 49 50 31 32 32 32 32 32 32 32 32 32 32 32 32 32 32 32 32 32 32 33 51 
35 15 16 16 16 16 16 16 16 16 16 16 16 16 16 16 16 16 26 43 44 41 42 16 16 16 16 16 54 16 16 16 16 16 16 18 36 20 16 16 16 18 36 20 16 16 16 16 16 37 38 39 16 16 16 16 16 16 16 16 16 16 46 47 48 16 16 16 16 16 16 16 21 45 23 16 69 41 42 16 16 16 16 70 71 72 73 74 16 16 16 75 16 56 56 16 16 16 16 16 16 16 56 56 56 56 16 16 16 56 54 16 16 62 76 66 16 16 16 16 16 16 26 43 28 16 16 16 16 16 16 16 16 16 54 16 16 16 54 16 16 77 78 79 80 37 38 39 16 25 16 16 16 16 16 49 50 31 32 32 32 32 32 32 32 32 32 32 32 32 32 32 32 32 32 32 33 51 
35 15 16 16 16 16 16 16 16 16 16 16 16 16 16 16 16 16 46 47 48 53 16 16 16 16 16 16 16 16 16 16 16 16 16 37 38 39 16 16 16 37 38 39 16 16 16 16 16 16 54 16 16 16 16 16 16 16 16 16 16 16 16 16 16 16 16 16 16 16 16 16 40 41 42 16 16 53 16 16 16 16 16 16 81 82 83 16 16 16 84 85 86 63 65 66 16 56 56 56 56 62 63 64 64 65 66 16 62 76 66 56 16 70 87 74 56 16 16 16 16 16 46 47 48 16 16 16 16 16 16 16 16 16 16 16 16 16 16 16 16 88 89 90 91 16 54 16 21 45 23 24 16 16 16 49 50 31 32 32 32 32 32 32 32 32 32 32 32 32 32 32 32 32 32 32 33 51 
35 15 16 16 16 16 16 16 16 16 16 24 16 16 16 16 16 16 16 24 16 16 16 16 17 16 16 16 16 16 16 16 16 16 16 16 54 16 16 16 16 16 54 16 16 16 16 16 16 16 16 16 16 16 16 16 16 16 16 16 16 16 16 16 16 16 16 16 16 16 16 16 16 53 16 16 16 16 16 16 17 16 16 92 21 93 94 16 16 16 95 96 97 71 73 74 62 63 64 64 65 98 71 72 72 73 74 56 70 87 99 76 66 16 81 62 76 66 16 16 16 16 16 16 16 16 16 16 16 16 16 16 16 16 16 16 16 25 16 16 16 100 101 102 103 16 16 16 40 41 104 43 28 16 16 49 50 31 32 32 32 32 32 32 32 32 32 32 32 32 32 32 32 32 32 32 33 51 
35 15 16 16 16 16 16 16 16 16 26 43 28 16 16 16 16 16 26 43 28 16 16 18 36 20 16 16 16 16 16 16 16 16 16 16 16 16 16 16 16 16 16 16 16 16 16 16 16 16 16 16 16 16 16 16 16 16 16 16 16 16 16 16 16 16 16 16 16 16 16 16 16 16 16 16 16 16 16 18 36 20 105 106 107 108 109 110 16 16 111 112 113 81 83 16 70 71 72 72 73 74 81 83 83 83 62 76 66 81 70 87 74 16 16 70 87 74 16 16 16 16 16 16 16 16 16 16 16 16 16 16 16 16 16 16 21 45 23 16 16 114 115 116 117 16 16 16 16 53 46 47 48 16 16 49 50 31 32 32 32 32 32 32 32 32 32 32 32 32 32 32 32 32 32 32 33 51 
35 15 16 16 16 16 16 16 16 16 46 47 48 16 16 16 16 16 46 47 48 16 16 37 38 39 16 16 16 16 16 16 16 16 16 16 16 16 16 16 16 16 16 16 16 16 16 16 16 16 16 16 16 16 16 16 16 16 16 16 16 16 16 16 16 16 16 16 16 16 16 16 16 16 16 16 16 16 16 37 38 39 118 119 120 121 122 123 124 16 16 125 16 16 126 126 126 127 128 128 128 126 126 126 126 126 129 87 74 16 16 81 16 16 16 16 81 16 16 16 16 16 16 16 16 16 16 16 16 16 16 16 16 16 16 16 40 41 42 16 16 114 130 131 132 16 16 16 16 16 16 16 16 16 16 49 50 31 32 32 32 32 32 32 32 32 32 32 32 32 32 32 32 32 32 32 33 51 
35 15 16 16 16 16 16 16 16 16 16 16 16 16 16 16 16 16 16 16 16 16 16 16 54 16 16 16 16 16 16 16 16 16 16 16 16 16 16 16 16 16 16 16 16 16 16 16 16 16 16 16 16 16 16 16 16 16 16 16 16 16 16 16 16 16 16 16 16 16 16 16 16 16 16 16 56 16 16 16 54 16 133 134 135 136 137 138 16 126 126 126 139 140 141 142 142 142 142 142 142 142 142 142 142 142 143 144 16 16 16 16 16 16 16 16 16 16 16 16 16 16 16 16 16 16 16 16 16 16 16 16 16 16 16 16 16 53 16 16 16 114 130 131 132 16 16 16 16 16 16 16 16 16 16 49 50 31 32 32 32 32 32 32 32 32 32 32 32 32 32 32 32 32 32 32 33 51 
35 15 16 16 16 16 16 16 16 16 16 16 16 16 16 16 16 16 16 16 16 16 16 16 16 16 16 16 16 16 16 16 16 16 16 16 16 16 16 16 16 16 16 16 16 16 16 16 16 16 16 16 16 16 16 16 16 16 16 16 16 16 16 16 16 16 16 16 16 16 16 16 16 16 16 62 76 66 16 16 16 16 145 146 147 148 149 150 151 141 142 142 143 152 153 154 154 154 154 154 154 154 154 154 154 154 155 156 16 16 16 16 16 16 16 16 16 16 16 16 16 16 16 16 16 16 16 16 16 16 16 16 16 16 16 16 16 16 16 16 16 114 130 131 132 16 16 16 16 16 16 16 16 16 16 49 50 31 32 32 32 32 32 32 32 32 32 32 32 32 32 32 32 32 32 32 33 51 
35 15 16 16 16 16 16 16 16 16 16 16 16 16 16 16 16 16 16 16 16 16 16 16 16 16 16 16 16 16 16 16 16 16 16 16 16 16 16 16 16 16 16 16 16 16 16 16 16 16 16 16 16 16 16 16 16 16 16 16 16 16 16 16 16 16 16 16 16 16 16 16 16 16 56 70 87 74 16 16 16 16 16 157 16 16 16 158 159 153 154 154 155 156 160 160 160 160 160 160 160 160 160 160 160 160 160 16 16 16 16 16 16 16 16 16 16 16 16 16 16 16 16 16 16 16 16 16 16 16 16 16 16 16 16 16 16 16 16 16 16 114 130 131 132 16 16 16 16 16 16 16 16 16 16 49 50 31 32 32 32 32 32 32 32 32 32 32 32 32 32 32 32 32 32 32 33 51 
35 15 16 16 16 16 16 16 16 16 16 16 16 16 16 16 16 16 16 16 16 16 16 16 16 16 16 16 16 16 16 16 16 16 16 16 16 16 16 16 16 16 16 16 16 16 16 16 16 16 16 16 16 16 16 16 16 16 16 16 16 16 16 16 16 16 16 16 16 16 16 16 16 62 76 66 81 16 16 16 16 16 16 16 16 16 16 16 16 160 160 160 160 16 16 16 16 16 16 16 16 16 16 16 16 16 16 16 16 16 16 16 16 16 16 16 16 16 16 16 16 16 16 16 16 16 16 16 16 16 16 16 16 16 16 16 16 16 16 16 16 114 130 131 132 16 16 16 16 16 16 16 16 16 16 49 50 31 32 32 32 32 32 32 32 32 32 32 32 32 32 32 32 32 32 32 33 51 
35 15 16 16 16 16 16 16 16 16 16 16 16 16 16 16 16 16 16 16 16 16 161 16 16 16 16 16 16 16 16 16 16 16 16 16 16 16 16 16 16 16 16 16 16 16 16 16 16 16 16 16 16 16 16 16 16 16 16 16 16 16 16 16 16 16 16 16 16 16 16 16 56 70 87 74 16 16 16 16 16 16 16 16 16 16 16 16 16 16 16 16 16 16 16 16 16 16 16 16 16 16 16 16 16 16 16 16 16 16 16 16 16 16 16 16 16 16 16 16 16 16 16 16 16 16 16 16 16 16 16 16 16 16 16 16 16 16 16 16 16 114 130 131 132 16 16 16 16 16 16 16 16 16 16 49 50 31 32 32 32 32 32 32 32 32 32 32 32 32 32 32 32 32 32 32 33 51 
35 15 16 16 16 16 16 16 16 162 161 16 16 16 16 16 16 16 16 16 16 163 164 165 16 16 16 16 16 16 16 16 16 16 16 16 16 16 16 16 16 16 161 16 16 16 16 16 16 16 16 16 16 16 16 16 16 16 16 16 16 16 16 16 16 16 16 16 16 16 16 62 76 66 81 161 16 16 16 16 16 16 16 16 16 16 16 16 16 16 16 16 16 16 16 16 16 16 16 16 16 16 16 16 16 162 162 161 16 16 16 16 16 16 16 16 16 16 16 16 16 16 16 16 16 16 16 16 16 16 16 16 16 16 16 16 16 166 16 167 16 114 130 131 132 16 16 16 16 16 16 16 16 16 16 49 50 31 32 32 32 32 32 32 32 32 32 32 32 32 32 32 32 32 32 32 33 51 
35 15 16 16 16 16 16 16 163 168 169 165 16 16 16 56 170 16 16 16 171 172 173 174 175 16 16 16 16 16 16 16 16 16 16 16 16 16 16 16 16 163 164 165 16 16 16 16 16 16 16 16 16 16 16 16 16 16 16 16 16 16 16 16 16 16 16 16 16 16 56 70 87 74 163 164 165 16 16 16 16 16 16 16 16 16 16 16 16 16 16 16 16 16 16 16 16 16 16 16 16 16 16 16 163 168 176 169 165 16 16 16 16 16 16 16 16 16 16 16 16 16 16 16 16 16 16 16 16 16 16 16 16 16 16 16 177 178 179 180 181 114 130 131 132 16 16 161 16 16 16 182 183 16 16 49 50 31 32 32 32 32 32 32 32 32 32 32 32 32 32 32 32 32 32 32 33 51 
35 15 16 16 16 16 16 171 172 184 185 174 175 16 62 186 187 188 16 16 16 189 190 191 192 16 16 56 16 16 16 16 16 193 16 16 194 16 16 16 171 172 173 174 175 16 16 162 162 161 16 16 16 16 16 16 16 16 16 16 16 16 16 16 16 16 16 16 16 62 76 66 81 171 172 173 174 175 16 16 16 16 16 16 16 16 16 16 16 16 16 16 16 16 16 16 16 16 16 16 16 16 16 171 172 184 195 185 174 175 16 16 16 16 16 16 16 16 16 16 16 16 16 16 16 16 16 16 16 16 16 16 16 16 16 16 196 197 198 199 200 201 202 203 132 16 163 164 165 16 204 205 206 207 16 49 50 31 32 32 32 32 32 32 32 32 32 32 32 32 32 32 32 32 32 32 33 51 
35 15 16 16 16 16 16 16 189 208 209 191 192 16 210 211 212 213 16 16 16 16 214 215 16 16 62 216 66 16 16 16 217 218 219 220 221 222 16 16 16 189 190 191 192 16 163 168 176 169 165 16 16 16 16 16 16 16 16 16 16 16 16 16 16 16 16 16 56 70 87 74 16 16 189 190 191 192 16 16 16 16 16 16 223 224 225 225 225 226 227 16 16 16 16 16 16 16 16 16 16 16 16 16 189 208 228 209 191 192 16 16 16 16 16 16 16 16 16 16 16 16 16 16 16 16 16 16 16 16 16 16 16 16 16 16 229 230 231 232 233 234 235 236 237 171 172 173 174 175 238 239 240 241 242 49 50 31 32 32 32 32 32 32 32 32 32 32 32 32 32 32 32 32 32 32 33 51 
35 15 16 16 16 16 16 16 16 214 243 215 56 56 244 245 246 247 223 248 227 16 16 16 16 16 210 249 250 16 92 16 251 252 253 254 255 256 124 16 16 16 214 215 16 257 258 184 195 185 174 175 16 16 16 16 182 183 16 16 16 16 16 16 16 16 16 62 76 66 81 16 16 16 16 214 215 16 16 16 16 16 16 259 260 261 262 262 262 263 264 265 16 16 16 266 267 16 16 16 16 16 16 16 16 214 243 243 215 16 16 16 16 16 16 16 16 16 16 16 16 16 16 16 16 16 16 16 16 16 16 16 16 16 16 16 229 268 231 269 270 271 272 273 274 16 189 190 191 192 275 276 277 278 279 49 50 31 32 32 32 32 32 280 281 32 32 32 32 32 32 32 32 32 32 32 33 51 
35 15 16 182 183 16 16 16 16 16 16 62 282 283 66 284 284 259 260 285 264 265 16 16 16 16 244 286 287 105 106 288 289 290 291 292 293 294 16 16 16 16 16 16 62 216 295 208 228 209 191 192 16 182 183 296 297 298 299 183 16 182 183 16 16 16 16 70 87 74 16 16 16 16 16 16 16 16 16 16 16 16 92 300 301 302 303 303 304 305 306 307 124 308 309 310 311 312 16 16 16 16 16 16 16 16 16 16 16 16 16 16 16 16 16 16 16 16 16 16 16 16 16 16 16 16 16 16 313 16 16 16 16 16 16 16 229 268 231 269 270 16 314 315 16 16 16 214 215 296 316 317 318 319 320 49 50 31 32 32 32 32 32 321 322 32 32 32 323 324 325 32 32 32 32 32 33 51 
35 15 296 297 298 299 183 182 183 16 16 210 326 327 250 16 92 328 329 330 306 307 124 331 332 16 166 284 16 333 334 335 336 337 338 339 340 341 16 16 16 16 308 16 210 249 250 214 243 243 215 16 204 205 342 343 344 345 346 347 348 205 206 207 16 16 16 16 81 16 16 16 16 16 16 16 16 16 16 16 16 105 106 349 350 351 352 353 354 355 356 357 358 359 360 361 362 274 16 16 16 266 16 16 16 266 16 16 16 16 16 16 16 16 16 16 16 331 332 16 182 183 16 16 16 363 364 365 366 367 16 16 16 16 16 92 368 369 231 269 270 16 266 267 16 16 370 371 204 372 373 374 375 376 320 49 50 31 32 32 32 32 32 377 378 281 32 32 379 380 381 32 32 32 32 32 33 51 
35 382 372 344 345 346 383 384 206 207 16 244 245 385 287 105 106 386 387 388 356 357 389 390 391 392 178 393 394 395 396 397 398 399 400 401 402 403 167 16 16 358 359 404 405 406 407 408 408 16 16 16 409 410 411 412 413 414 415 416 417 410 418 241 242 16 408 408 16 16 16 16 16 16 16 16 16 16 16 16 166 118 419 420 421 422 423 424 425 426 427 428 429 430 213 314 315 16 16 16 431 432 433 16 434 432 435 16 16 16 16 16 16 331 332 16 389 390 391 436 205 206 207 16 437 438 439 440 441 442 16 16 363 16 105 106 443 444 445 269 270 309 446 447 433 448 449 450 451 452 453 454 455 456 457 49 50 31 32 32 32 32 32 377 458 322 32 32 32 32 32 32 32 32 280 281 33 51 
35 459 460 461 414 415 462 463 418 241 242 408 464 464 16 118 465 466 467 468 427 428 469 470 471 472 197 473 231 474 475 476 477 478 479 480 481 482 483 181 484 429 485 486 487 488 487 487 489 490 16 491 492 493 494 495 496 497 498 499 500 493 501 502 279 503 504 489 505 16 16 16 16 16 16 408 408 408 16 177 178 506 507 508 509 510 511 512 513 514 515 428 516 517 247 16 16 16 16 431 518 519 520 16 521 522 523 435 16 408 408 408 389 390 391 524 469 470 471 525 410 418 241 526 527 528 529 529 530 531 16 532 533 534 118 465 535 536 537 538 270 539 540 541 542 543 544 545 546 547 548 549 550 551 552 553 50 31 32 32 32 32 32 377 32 378 281 32 32 32 32 32 32 32 321 322 33 51 
35 554 555 556 497 557 558 559 501 502 560 504 487 489 490 561 562 398 563 564 565 566 114 567 568 569 570 571 572 573 574 575 576 577 578 572 579 580 581 582 583 584 585 586 587 587 587 587 588 589 590 591 592 593 594 595 596 597 598 599 600 593 601 602 603 604 605 606 607 608 16 16 16 484 503 504 487 489 490 609 610 578 611 572 572 612 613 614 615 616 565 566 16 284 617 16 16 484 309 618 619 620 621 16 521 622 623 624 625 504 487 489 626 627 628 629 114 567 630 631 493 501 632 633 634 635 636 636 637 638 639 640 641 638 642 562 398 563 643 644 645 646 647 648 649 650 651 652 653 654 655 656 657 658 502 659 660 661 662 662 662 662 663 664 662 665 666 662 662 662 662 662 662 663 664 667 668 51 
669 670 671 672 673 674 675 676 677 678 679 680 681 682 683 684 685 686 687 688 689 690 691 692 693 694 695 696 697 698 699 700 701 702 696 697 697 703 704 705 706 707 708 709 709 709 709 709 709 710 710 710 711 712 713 714 714 714 714 715 711 712 713 715 710 710 716 717 718 719 16 16 720 721 722 680 681 682 683 723 724 696 697 697 697 703 725 726 727 688 689 690 728 729 730 731 720 721 732 733 734 735 736 16 737 738 739 740 741 680 681 682 742 743 744 745 746 692 747 748 749 677 750 751 752 753 753 753 754 755 756 757 758 755 759 685 686 760 761 762 763 764 765 766 767 746 743 744 768 769 770 771 771 772 678 773 774 775 776 776 776 776 777 778 776 776 779 776 776 776 776 776 776 777 778 780 781 782 
783 784 785 786 786 786 787 788 786 789 790 791 791 791 790 790 792 790 793 794 795 796 790 797 798 790 799 790 790 790 800 801 790 799 790 790 790 790 802 803 804 805 806 806 806 806 806 806 806 806 806 806 806 806 806 806 806 806 806 806 806 806 806 806 806 806 806 807 808 809 810 810 811 812 813 791 791 791 790 790 799 790 790 790 790 790 800 801 793 794 795 796 790 814 815 816 811 812 813 817 818 819 820 810 821 822 823 824 790 791 791 791 790 797 798 790 790 797 798 825 826 786 827 828 828 828 828 828 828 828 790 790 828 828 790 792 790 793 786 802 829 830 831 832 790 790 797 798 790 833 786 786 786 786 789 790 834 835 835 835 835 835 835 835 835 835 835 835 835 835 835 835 835 835 835 836 837 838 